吧	particle indicating polite suggestion; | onomatopoeia | bar (serving drinks, providing internet access, etc.)
白	white; snowy; pure; bright; empty (Kangxi radical 106)
百	hundred
帮助	help; assist; aid
报纸	newspaper
比	compare; (indicates comparison) (Kangxi radical 81); to gesticulate as one talks
别	don't do something; don't | depart; | other; difference; distinguish
宾馆	guesthouse; hotel
长	long; length | grow; chief (Kangxi radical 168)
唱歌	sing (a song)
出	go out; occur
穿	to wear; put on; penetrate
次	(mw for number of times of occurrence); nth; order
从	from; obey; observe
错	mistake; error; blunder; miss an opportunity
打篮球	play basketball
大家	everyone
到	arrive (at a place); until (a time)
得	(complement particle)
等	to wait; rank; equal; etc.
弟弟	younger brother
第一	first; number 1
懂	understand; know
对	correct; a pair; to face; be opposite; to; towards
房间	room
非常	extremely; extraordinary; very
服务员	waiter/waitress; server; attendant
高	high; tall (Kangxi radical 189)
告诉	to tell; inform
哥哥	older brother
给	to give; to grant; (passive particle)
公共汽车	(public) bus
公司	company; corporation
贵	expensive; noble; honorable; Guizhou province (abbreviation)
过	to pass; to cross; go over; (indicates a past experience)
还	still; yet; in addition; even
孩子	child; children; son or daughter
好吃	tasty
黑	black; dark (Kangxi radical 203); Heilongjiang province (abbreviation)
红	red; symbol of success; bonus; popular
火车站	train station
机场	airport; airfield
鸡蛋	(chicken) egg
件	(mw for things, clothes, and items)
教室	classroom
姐姐	older sister
介绍	to introduce; recommend; introduction
进	enter; come in
近	near; close (to)
就	then; at once; just; only; with regard to
觉得	feel; think
咖啡	coffee
开始	begin; to start; beginning
考试	test; exam; to give or take a test
可能	possible; maybe
可以	can; may; possible; okay
课	class; subject; lesson; course
快	fast; quick; swift
快乐	happy
累	tired
离	leave; depart; go away; apart from
两	two; 2; both; (unit of weight equal to 50 grams)
零	zero; remnant
路	road; path; journey; route
旅游	trip; journey; tour
卖	to sell
慢	slow
忙	busy
每	each; every
妹妹	younger sister
门	door; opening; gate (Kangxi radical 169)
面条	noodles
男	male
您	you (polite)
牛奶	cow's milk
女	woman; female (Kangxi radical 38)
旁边	side, beside
跑步	to run; to jog
便宜	cheap
票	ticket; bank note; a vote
妻子	wife
起床	get out of bed
千	one thousand
铅笔	pencil
晴	clear; fine (as of weather)
去年	last year
让	ask; let; yield
日	sun; day; date; time (Kangxi radical 72)
上班	go to work; be on duty
身体	health; (human) body
生病	get sick; fall ill
生日	birthday
时间	time; period
事情	matter; affair; thing; business
手表	wristwatch
手机	mobile (cell) phone
说话	to talk; speak
送	deliver; to carry; to give; send
虽然	although; even though
但是	but; however
它	it
踢足球	to play football/soccer
题	topic; subject; question on a test or assignment
跳舞	to dance
外	outer; outside; in addition; foreign
完	to finish; be over; complete
玩	to play; have a good time; visit; enjoy
晚上	evening; night
往	to go (in a direction); towards; in the past
为什么	why?; for what reason?
问	ask; inquire
问题	question; problem
西瓜	watermelon
希望	to hope; wish for; to desire
洗	to wash; bathe
小时	hour
笑	to laugh; to smile
新	new; Xinjiang autonomous region (abbreviation)
姓	surname; family name
休息	to rest; take a break
雪	snow
颜色	color
眼睛	eye
羊肉	mutton; lamb
药	medicine; drug; cure; chemical
要	to want; to need; will/shall; important
也	also; too
一起	together; in the same place
一下	a little bit/while; one time; once
已经	already
意思	meaning; idea; opinion
因为	because
所以	so; therefore; as a result
阴	cloudy (weather); yin (the negative principle of Yin and Yang); secret; the moon; negative; shade
游泳	to swim
右边	the right (as opposed to left) side
鱼	fish (Kangxi radical 195)
远	far; distant; remote
运动	(physical) exercise; movement; sports; campaign
再	again; once more
早上	(early) morning
丈夫	husband; man
找	try to find; look for; seek; to give change
着	-ing (indicating action in progress)
真	real; true; genuine
正在	in the process of (doing something); currently
知道	know; be aware of
准备	prepare; get ready
走	to walk; to go; to move (Kangxi radical 156)
最	the most; -est; (indicator for superlative)
左边	the left side; the left
